############################
#..........................#
#..........................#
#..........................#
#......###################.#
#........................##
#........................#
#........................#
#........................#
#........................#
#........................#
#........................#
#........................#
#........................#
#........................#
##########################
